############### #########
#     #               # #
##### # ####### ##### # #
#         #     #   #   #
######### # ##### ### ###
# #     # # # #         #
# # # ### ### ### ##### #
# # #     #     #     # #
# # # ######### ##### ###
#   #   #   # # #   #   #
######### ### # ### # # #
#           # #       # #
# # ### ### # ### ##### #
# # # # # #           # #
##### # # ####### # # # #
#     #     # #   # # # #
##### ####### ######### #
# #   #   #       #     #
# ### # ### ##### ### # #
#   #       # #       # #
### # ##### # # ##### # #
#         #   # #     # #
### ##### ##### ####### #
#     #   #     #       #
### #####################