################### #####
#   # #       #   #     #
### # ##### # # ##### ###
# #         #     # #   #
# ######### ##### # ### #
# #         #       #   #
# ######### ####### ### #
# #     #   #   # #     #
# ### # ### # # # # #####
#   # #       #   #     #
# ### # # # ####### ### #
#     # # #     #     # #
##### ### ### ##### ### #
# #   #   # # #     #   #
# # ####### # ### ##### #
#     # # # # #     #   #
### ### # # # ### #######
# # #     # # # #       #
# # # ##### ### ### ### #
#     #         #     # #
# # # ### ##### ####### #
# # #       # #     #   #
# # ##### ### ##### #####
# # #       #           #
### #####################