####### #################
#     #   #   #   # #   #
##### ### # ##### # ### #
#         # # #       # #
# ### ##### # ### # ### #
# # #         # # #     #
### # # ####### # ### ###
#     #         # #     #
##### ##### # ####### ###
#     #     #   #       #
# ########### ##### ### #
# #       #       # #   #
# ### ### ### ####### # #
# # #   # #     # #   # #
### ##### ### # # ### ###
#         #   #   #     #
### ##### ##### ##### ###
#   #       # #     #   #
# # ####### # ### ### ###
# # #           #   #   #
# ######### # ### ### ###
# #         #       #   #
##### ####### ### # # ###
#         #     # #     #
######### ###############