####### #################
#   #       #     #     #
### # ### ####### ### ###
#     #       #         #
##### ####### # # ##### #
#     #   #     # #     #
######### ##### #########
#   # #                 #
### # ######### ##### ###
#     #     # #   #     #
### # ### # # # ##### # #
#   #     #   # #   # # #
##### # ######### ##### #
#     # # #         #   #
# ### ### # ##### ##### #
# #             #       #
# ### # # ######### ### #
# #   # #   #   #   #   #
# ### # ####### ####### #
# #   #     #           #
##### ### ##### ### # # #
# #     #   #   # # # # #
# ####### # ##### ### ###
#         # #           #
################### #####